proc => processo
prfo => processo_formatado
orig => origem
trib => tribunal
orga => orgao_julgador
tipo => tipo_documento
sigc => sigla_classe
clas => classe
obpr => objeto_processo
dtdp => data_decisao_pesq
dtde => data_decisao
dtpp => data_publicacao_pesq
dtap => data_alteracao_pesq
relc => relator_convocado
resp => relator_suplente
rela => relator_acordao
rev => revisor
rel => relator
iteo, inte => inteiro_teor
lite => link_inteiro_teor
txto => txt_origem
deci => decisao
emen => ementa
refl => ref_legislativa
oure => outras_referencias
cata => catalogo
inde => indexacao
dout => doutrina
suce => sucessivos
prec => precedentes
obs => observacoes
outf => outras_fontes
font => fonte_publicacao